1111111111
1000000001
1000011111
1000000001
1001000001
1001000001
1001000001
1001000001
1001011111
1000000001
1000001001
1000001001
1000001$01
1000001001
1111111111